_ _ _ _ _ _ _ _ _ _
_ _ _ _ _ _ _ _ _ _
t _ t _ _ t _ _ _ _
_ t _ _ t _ _ _ t _
_ _ _ t _ _ _ t _ _
_ t _ _ _ t _ _ _ t
_ _ _ t _ _ _ _ _ _
