_ _ _ _ _ _ _ _ _ _ _ _ _ _ _ _ _ _ _ _
_ _ _ _ _ _ _ _ _ _ _ _ _ _ _ _ _ _ _ _
_ _ _ _ _ e _ _ _ _ _ e _ _ _ _ _ _ _ _
_ _ _ t _ t _ _ _ _ _ t _ _ _ _ _ _ _ _
_ _ _ _ _ _ _ _ _ s _ _ _ e _ _ _ _ _ _
_ _ _ _ _ _ _ s _ _ _ _ _ t _ _ t _ _ _
_ _ e e _ _ _ _ _ m _ _ _ e _ _ _ _ _ _