_ _ _ _ _ _ _ _ _ _ _ _ _ _ _ _ _ _ _ _ _ _ _ _ _ _ _ _ _ _ _ _ _ _ _ _ _ _ _ _ _ _ _ _ _ _ _ _ _ _ _ _ _ _ _ _ _ _ _ _
f _ _ e _ _ _ _ _ _ _ _ _ _ _ _ _ _ _ _ _ _ _ _ _ _ _ _ _ _ _ _ _ _ _ _ _ _ _ _ _ _ _ _ _ _ _ _ _ _ _ _ _ _ _ _ _ _ _ _
t t t t t t _ _ _ e _ _ _ _ _ _ _ _ _ _ _ _ _ _ _ _ _ _ _ _ _ _ _ _ _ _ _ _ _ _ _ _ _ _ _ _ _ _ _ _ _ _ t t t t t _ _ _
_ _ _ _ _ _ _ t t t t t _ _ _ e _ _ _ _ _ _ _ _ _ _ _ _ _ _ _ _ _ _ _ _ _ _ _ _ _ _ _ _ _ _ e _ t _ _ _ _ _ _ _ _ _ _ _
_ _ _ _ _ _ _ _ _ _ _ _ _ t t t t t _ _ _ _ _ _ e _ _ _ _ _ _ _ _ _ _ _ _ e _ _ _ _ _ _ t t t t t _ _ _ _ _ _ _ _ _ _ _
s s s s s s s s s s s s s _ _ _ _ _ _ _ _ _ t t t t t _ _ _ _ _ _ _ _ t t t t t _ _ _ e _ _ _ _ _ _ _ _ _ _ _ _ _ _ _ _