_ _ _ _ _ _ _ _ _ _ _ _ _ _ _ _ _ _ _ _ _ _ _ _ _ _ _ _ _ _ _ _ _ _ _ _ _ _ _ _ _ _ _ _ _ _ _ _ _ _ _ _ _ _ _ _ _ _ _ _
_ _ _ f _ r _ _ _ _ _ _ _ _ _ _ _ _ _ _ _ _ _ _ _ _ _ _ _ _ _ _ _ _ _ _ _ _ _ _ _ _ _ _ _ _ _ _ _ _ _ _ _ _ r _ _ _ _ _
t t t t t t _ r _ e _ r _ _ _ _ _ _ _ _ _ _ _ _ _ _ _ _ _ _ _ _ _ _ _ _ _ _ _ _ _ _ _ _ _ _ _ _ _ _ r _ t t t t t _ _ _
_ _ _ _ _ e _ t t t t t _ r _ e _ r _ _ _ _ _ _ _ _ _ _ _ _ _ _ _ _ _ _ _ _ _ _ _ _ _ _ r _ e _ t t t t t _ _ _ _ _ _ _
_ _ _ _ _ t t t _ _ _ _ _ t t t t t _ _ _ _ _ _ e _ _ _ _ _ _ _ _ _ _ r _ e _ r _ _ _ _ t t t t t _ _ _ _ _ _ _ _ _ _ _
s s s s s s s s s s s s s _ _ _ _ _ _ _ _ _ t t t t t _ _ _ _ _ _ _ _ t t t t t _ _ _ e _ _ _ _ _ _ _ _ _ _ _ _ _ _ _ _