_ _ _ _ _ _ _ _ _ _ _ _ _ _ _ _ _ _ _ _ _ _ _ _ _ _ _ _ _ _ _ _ _ _ _ _ _ _ _ _ _ _ _ _ _ _ _ _ _ _ _ _ _ _ _ _ _ _ _ _
_ _ _ _ _ r _ _ _ _ _ _ _ _ _ _ _ _ _ _ _ _ _ _ _ _ _ _ _ _ _ _ _ _ _ _ _ _ _ _ _ _ _ _ _ _ _ _ _ _ _ _ _ _ _ _ _ _ _ _
t t t t t t _ e r _ s r _ _ _ _ _ _ _ _ _ _ _ _ _ _ _ s _ _ _ _ _ _ _ _ s s r _ _ e _ _ _ _ _ _ _ _ r _ e _ _ f _ _ _ _
_ _ _ _ _ e r t t t t t _ r _ e _ r _ _ _ _ _ _ s t t t t _ _ _ _ _ _ _ t t t t _ t t _ s s e _ _ _ t t t t t t t t t t
_ _ _ _ _ t t t _ _ _ _ _ t t t t t _ _ _ e _ t t t t _ _ _ _ e s _ _ _ _ e _ r _ _ _ _ t t t t t _ _ _ _ _ _ _ _ _ _ _
_ _ _ _ _ _ _ _ _ _ e _ _ _ _ _ s t t t t t s _ e _ _ _ _ _ s t t t t t t t t t s _ _ _ _ s s s _ _ _ _ _ _ _ _ _ _ _ _